Schnapps - Licor *
Corpo de bombeiros - Estação de Bombeiros *
Modest Park - Parque Modesto *
Menu de embarque - Menu de Barco *
Dolphinarium - Golfinário *
Campo de salto - Campo de Lúpulo *
Glassmakers - Fabricantes de Vidro *
SHORTAGE - FALTA *
CORNUCOPIA - CORNUCÓPIA *
Knitters Framework - Tear de Roupas de Trabalho *
Pequeno Armazén *
Post Office - Correios *
Steppe - Estepe*
Light Bulb - Lâmpada elétrica
Work Clothes - Roupas de Trabalho
Sheepfold
Fonte de jardim
Special Ornaments - Decorações Especiais
Christimas Decoration - Decorações de Natal
Timber
Malthouse
Fishground
Pickup - Coletar
Lateen Sails - Velas Triangulares
She's a Qu

Caoutchouc - Borracha
malthouse - Maltaria
Royal Ship-of-the-Line - Navio-da-linha Real
Ship-of-the-Line - Navio-da-linha
Navio de linha - Navio-da-linha
Remessa da linha - Navio-da-linha
Plantain - Banana



____________________Procurar__________________ 
Bread
Sausages - Salsichas
Bricks - Tijolos
Sails - Velas
Small Harbour - Porto Pequeno
Steal Beams - Vigas de Aço
Soap - Sabão
Weapons - Armas
Beer - Cerveja
Quaint Park - 
Windows - Janela
Sewing Machines - Máquina de Costura
Fur Coats
Reinforced Concrete - Concreto Reforçado
Eletricity - 
Spectacles - 
Elaborate Park - 
Large Harbour - 
Advanced Weapons - 
Penny-Farthings - 
Steam Motors - 
Café - 
Pocket Watches - 
Work Clothes - Roupas de Trabalho
Farmers - Agricultores
Workers - Operários
Artisans - Artesãos
Engineers - Engenheiros
Investors - Investidores
